"filename", "language", "Handlebars", "JSON", "JavaScript", "comment", "blank", "total"
"c:\Users\KCTCodingIm12\Desktop\KCI PI Beta 3.0\app\assets\vendor\echarts\echarts.common.js", "JavaScript", 0, 0, -48096, -8028, -458, -56582
"c:\Users\KCTCodingIm12\Desktop\KCI PI Beta 3.0\app\assets\vendor\echarts\echarts.common.min.js", "JavaScript", 0, 0, -3, -40, -3, -46
"c:\Users\KCTCodingIm12\Desktop\KCI PI Beta 3.0\app\assets\vendor\echarts\echarts.esm.js", "JavaScript", 0, 0, -72602, -12394, -735, -85731
"c:\Users\KCTCodingIm12\Desktop\KCI PI Beta 3.0\app\assets\vendor\echarts\echarts.esm.min.js", "JavaScript", 0, 0, -2, -41, -3, -46
"c:\Users\KCTCodingIm12\Desktop\KCI PI Beta 3.0\app\assets\vendor\echarts\echarts.esm.min.mjs", "JavaScript", 0, 0, -2, -41, -3, -46
"c:\Users\KCTCodingIm12\Desktop\KCI PI Beta 3.0\app\assets\vendor\echarts\echarts.esm.mjs", "JavaScript", 0, 0, -72602, -12394, -735, -85731
"c:\Users\KCTCodingIm12\Desktop\KCI PI Beta 3.0\app\assets\vendor\echarts\echarts.js", "JavaScript", 0, 0, -72665, -12394, -738, -85797
"c:\Users\KCTCodingIm12\Desktop\KCI PI Beta 3.0\app\assets\vendor\echarts\echarts.min.js", "JavaScript", 0, 0, -3, -40, -3, -46
"c:\Users\KCTCodingIm12\Desktop\KCI PI Beta 3.0\app\assets\vendor\echarts\echarts.simple.js", "JavaScript", 0, 0, -35320, -5762, -319, -41401
"c:\Users\KCTCodingIm12\Desktop\KCI PI Beta 3.0\app\assets\vendor\echarts\echarts.simple.min.js", "JavaScript", 0, 0, -3, -40, -3, -46
"c:\Users\KCTCodingIm12\Desktop\KCI PI Beta 3.0\app\assets\vendor\echarts\extension\bmap.js", "JavaScript", 0, 0, -296, -63, -10, -369
"c:\Users\KCTCodingIm12\Desktop\KCI PI Beta 3.0\app\assets\vendor\echarts\extension\bmap.min.js", "JavaScript", 0, 0, -1, -18, -3, -22
"c:\Users\KCTCodingIm12\Desktop\KCI PI Beta 3.0\app\assets\vendor\echarts\extension\dataTool.js", "JavaScript", 0, 0, -289, -100, -15, -404
"c:\Users\KCTCodingIm12\Desktop\KCI PI Beta 3.0\app\assets\vendor\echarts\extension\dataTool.min.js", "JavaScript", 0, 0, -1, -18, -3, -22
"c:\Users\KCTCodingIm12\Desktop\KCI PI Beta 3.0\app\assets\vendor\echarts\package.json", "JSON", 0, -3, 0, 0, 0, -3
"c:\Users\KCTCodingIm12\Desktop\KCI PI Beta 3.0\views\layouts\main.handlebars", "Handlebars", -1, 0, 0, 0, 0, -1
"Total", "-", -1, -3, -301885, -51373, -3031, -356293